Windsor|Canada|YQG
Toronto|Canada|YYZ
Montreal|Canada|YUL
Yerevan|Armenia|EVN
Mumbai|India|BOM
London|Canada|YXU
London|England|LHR
Islamabad|Pakistan|ISB
Delhi|India|DEL
Paris|France|CDG
Vancouver|Canada|YVR
Halifax|Canada|YHZ
Winnipeg|Canada|YWG
Edmonton|Canada|YEG
Calgary|Canada|YYC
Ottawa|Canada|YOW
Dubai|UAE|DXB
New York|USA|JFK
New York|USA|LGA
Detroit|USA|DTW
Frankfurt|Germany|FRA
Berlin|Germany|BER
Istanbul|Turkey|IST
Madrid|Spain|MAD
Hong Kong|China|HKG
Tokyo|Japan|HND
Sydney|Australia|SYD
Split Croatia|Croatia|SPU
Warsaw|Poland|WAW
Munich|Germany|MUC
Providencials|Turks and Caicos|PLS
Athens|Greece|ATH
Kolkata|India|CCU